#######A###########
#.......#.#...#...#
#.###.###...#.#.#.#
#...#.....#.#...#.#
#.#.###.#.#.#.###.#
#.#.....#...#.#...#
#.###########.#.#.#
#.#.#.....#...#.#.#
#.#.#####.#####.#.#
#.........#.....#.#
###############B###
